     #####
    ##   #
    #    #
  ###    ######
  #O#O# ##O   #
### ###  ##   #
#   #  @  ## ##
#     @A@     #
#   #  @  #   #
######   ### ##
 #  O## #### #
 #           #
 ##  #########
  ####