 ###########
##         ##
#  @     @  #
# @# #O# #@ #
#    #@#    #####
#  ###O###  #   #
#  O@OAO@O      #
#  ###O###  #   #
#    #@#    #####
# @# #O# #@ #
#  @     @  #
##         ##
 ###########