      ###
      #O#
  #####O#####
 ##         ##
##  # # # #  ##
#  ##     ##  #
# ##  # #  ## #
#     @A@     #
####  ###  ####
   #### ####